7 5
. . . . . . .
. @ . . . * .
. . . . . . .
. * . . . * .
. . . . . . .